Apellidos,1a (5),1b (30/35),2a (5),2b (30/35),3a (30/35),Total,Observaciones
GarciaDavid,5,35,5,35,30,110,"1a. Open_Read se define como int pero no devuelve nada. El programa no para su ejecucion si el input no es el adecuado. 3. walk empieza con i=0, lo que hace que llame a step con i=-1."
JaramilloDavid,5,35,5,35,25,105,"3. La ""M"" en el archivo de final stats correspondia al numero de marchas. Los pasos de la marcha no estan distribuidos homogeneamente sobre la esfera"
VarelaLucas,5,35,0,25,25,90,"1. Estilo: las variables se declaran arriba de todo. 2a. No corre si alguno de los angulos es 0. 2b. Falla con 0 0 90 0. Falla en phi con 30 0 150 90. 2b. La salida se pide solamente los numeros. 3 D solamente llega hasta 200, los pasos no estan distribuidos homogeneamente sobre la esfera. el ""M"" del archivo corresponde al numero de marchas"
MendezRudy,5,30,5,15,15,70,"2a. A la salida se piden solamente los numeros, no comas ni parentesis. Theta no va entre -180 y 180! La trayectoria no corresponde al camino mas corto sobre la esfera!. 3. Cada paso no esta distribuido homogeneo sobre la esfera. La distancia al origen del sistema de coordenadas esta mal calculada. No logro entender todavia los picos en N vs D."
Cuervo Gomez,5,30,5,25,20,85,"2. No reproduce la trayectoria 30 0 150 90.  3: Mal escritos los resultados, y no se hacen pasos homogeneos en la esfera."
Perez Consuegra,5,30,5,25,25,90,"2. No reproduce la trayectoria 30 0 150 90, 3. Pasos no son homogeneos sobre la esfera"
Rosales Cote,5,30,5,15,25,80,"2. No es el camino mas corto sore una esfera, sino sobre un plano. 3: Los pasos no son homogeneos sobre la esfera"
Ariza fuentes,5,30,5,20,15,75,"2b No reproduce las trayectorias 0 0 90 0, 30 0 150 90. 3: Pasos no dsitribuidos homogeneamente y no corre el codigo!"
Cuartas Martinez,5,30,5,15,30,85,"2. No es el camino mas corto sore una esfera, sino sobre un plano."
Solano Gomez,5,30,5,0,20,60,"1. Imprime cosas no pedidas. Pero el resultado es correcto. 2b No lo hizo. 3: Pasos no distribuidos homogeneamente, no esta bien hecha la caminata aleatoria, resultados incongruentes de D vs <Nd>"
Sanabria Ordonez,5,30,0,20,25,80,"2a, Esta en radiades. 2b, Error en trayectoria 30  0 150 90. 3. Pasos no distribuidos homogeneamente."
Rivera Guerrero,5,30,5,15,25,80,2. La trayectoria no corresponde al camino mas corto sobre la esfera. No compilaba estaba mal declarada una variable. 3. Pasos no distribuidos homogenemente en una esfera
Pizano Wagner,5,30,5,25,10,75,"2. El orden del input esta invertido, no repdroduce la oribta 30 150 0 90. 3: Compila pero no corre, vota resultados incongruentes. "
Castillo Ruiz,5,15,5,25,25,75,"1b: La funcion Suma_nDecimales no imprime nada, además esta mal implementado y la respuesta es incorrecta. 2b. Falla con 0 0 90 0. Falla en phi con 30 0 150 90. 2b. La salida se pide solamente los numeros. 3 Pasos no estan uniformemente distribuidos sobre la esfera"
Revelo Obando,5,30,5,20,25,85,2. El orden en el input de los angulos esta invertido.  Los pasos no estan distribuidos unifromemente sobre la esfera
Alvis Narvaez,5,30,0,0,5,40,"2. No lo hizo. 3. El numero que se entra por parametro es el numero de marchas, no el numero de pasos. El paso no es de 1, solo se generan 3 numeros aleatorios x,y,z entre -4 y 4, y se halla la raiz de la suma de sus cuadrados. No se entrega el archivo pedido de estadisticas. Nunca se involucran las distancias dadas."
Arango Montoya,5,30,5,20,30,90,"2b. No sirve para 0 0 99 0. No sirve para 30 150 0 90. Imprime los angulos en radianes. Imprime en pantalla los datos requeridos, pero tambien otros que no se necesitan y dañan la trayectoria. 3. No se nombra el archivo de final stats correctamente. Precaución: Se declara una variable dentro de un for (no se le baja por esto). "
Farfan Romero,5,30,5,15,25,80,2b. La trayectoria no corresponde al camino mas corto sobre la esfera. 3. Los pasos de la marcha no estan distribuidos homogeneamente sobre la esfera
Umana Rojas,5,30,5,18,15,73,"2b. La trayectoria no corresponde al camino mas corto sobre la esfera. 3. No se nombra el archivo de final stats correctamente. Los pasos de la marcha no estan distribuidos homogeneamente sobre la esfera. El paso no tiene magnitud 1 porque paso se genera 3 veces en cada funcion de make walk en cada coordenada. No sirve hacer las marchas separadas, la distancia no es la correcta."
Olaya Cortes,5,30,5,15,5,60,"2b. La trayectoria no corresponde al camino mas corto sobre la esfera. Falla con 30 0 150 90. 3a. La magnitud del paso no es de 1. El programa no corre, da un segmentation fault. No se crea bien el nombre del archivo de final stats. El programa no hace lo que se pide, solo imprime las posiciones de x,y,z. "
Garzon Alvarado,2,30,5,15,15,67,"1a. Da el error pero no para la ejecución del programa. 2b. La trayectoria no corresponde al camino mas corto sobre la esfera. 3. Los pasos no están distribuidos homogénamente sobre una esfera. El programa no corre, no da resultados al final toca matarlo."
Linares Rugeles,3,27,5,20,30,85,"1a. El max esta mal definido, tiene un cero de mas. Funciona si se quita n=6, despues de  pedir el valor se fijo el n. 2b. Para los angulos: 0 0 99 0 bota el error: ""El punto de salida es igual al punto de llegada"" cuando no es cierto. Se evalua mal esa condicion.No funciona con: 30 0 150 90."
Rodriguez Parra,2,15,5,30,5,57,"1a. Da el error pero no para la ejecución del programa. 1b. El programa no corre, da un segmentation fault. No aloca memoria. 2. Felicitaciones por el codigo tan ordenado y con comentarios. 3. Se manda algo que no tenia que ver con lo que pedia la tarea, se hace una marcha en 1D y no se generan los archivos pedidos, solo se botan las distancias de esa marcha."
Perez Angel,5,30,5,30,15,85,"3. distancia(int n) devuelve la distancia desde el origen hasta N pasos, entonces no se le mete como parametro las distancias fijas 10, 20, 30... sino un numero de pasos. Ahí esta el error. El promedio no es de distancias tampoco sino de numero de pasos para llegar a esa distancia. Consejo: Usar srand48(time(NULL)) para que sea lo mas aleatorio posible no sirve cuando es el computador el que hace los procesos porque al ser tan rapidos la semilla no alcanza a cambiar y se hace antes lo opuesto, dejarla fija (dependiendo claro de cuanto se demore el proceso en cuestión). "
Rey Puentes,0,15,5,15,0,35,"1a. No lo hace. 1b. No aloca memoria. El programa no funciona correctamente. 2b. La trayectoria no corresponde al camino mas corto sobre la esfera. 3. No hace el ejercicio, solo crea un archivo con las distancias otorgadas y unos N que no corresponden a los solicitado ya que no se hizo la marcha en 3D"
Rueda Corredor,5,30,3,15,5,58,"2a. Los angulos van de 0 a 90 y 0 a 180, no de -90 a 90 y -180 a 180. 2b. La trayectoria no corresponde al camino mas corto sobre la esfera. 3. El programa no hace lo que se pide, no es una marcha en 3D y no da los resultados como distancias 10, 20, 30,... y el promedio de los pasos para llegar a ese."
Diaz Meza,5,30,5,15,20,75,"2b. La trayectoria no corresponde al camino mas corto sobre la esfera. 3. los pasos no están distribuidos homogénamente sobre una esfera. La marcha no esta correcta, no se ve la relacion cuadratica entre D y el numero de pasos"
Cortes Calderon,5,30,5,15,0,55,3. No lo hizo. Falla con 0 0 99 0. Falla con 30 150 0 90. El programa no funciona correctamente.
