Apellidos,Nombres,Punto 1,Punto 2,Total,Comentarios
Estudiante,Conbono,70,70,140,
Estudiante,Sinbono,50,50,100,
Aguilar,Juan,30,50,80,1. programa da segmentation fault
Barrera,Monica,35,50,85,P1. Segmentation fault. Error al graficar (pero funciona en Ipython notebook). Makefile OK
Farfan,Juan Camilo,50,40,90,P2. No corre el makefile
Ferrer,Laura,25,30,55,"P1. Segmentation Fault. Integrador Euler. Error al graficar. Makefile OK. P2. no corre el makefile, no hace el gif"
Gomez,Daniel,35,10,45,"P1. Trayectoria.dat = nan nan nan. Graficas OK. Makefile OK. P2. No corre el makefile, falla en la solucion de la ecuacion"
Hernandez,Yvan,32,50,82,"P1. Trayectoria lineal. Error nombre archivo de salida.dat. Graficas OK, Makefile OK."
Hong,Luis,0,0,0,
Molano,Juan Pablo,32,50,82,P1 Trayectoria lineal. Graficas ok. Makefile peque√±o error con los nombres.
Perez,Juan,0,0,0,
Vargas,Kevin,29,50,79,"P1. Integrador EULER, trayectoria lineal. Graficas OK. Makefile OK"