Apellidos,Nombres,Punto 1,Punto 2,Total,Comentarios
Estudiante,Conbono,70,70,140,
Estudiante,Sinbono,50,50,100,
Aguilar,Juan,20,20,40,"1. Makefile no funciona. No hay graficas al final. No hay resultados al final.
"
Barrera,Monica,45,45,90,1. Solamente el makefile y graficas funcionan bien. MCMC no da las respuestas correctas.
Farfan,Juan Camilo,30,20,50,1. Solamente el makefile y graficas funcionan bien (aunque son imposibles de ver con los puntos). MCMC no da las respuestas correctas. 2. No hay makefile. No hay py file.
Ferrer,Laura,45,45,90,Solamente el makefile y graficas funcionan bien. MCMC no da las respuestas correctas.
Gomez,Daniel,60,45,105,1. Lss caminatas estan muy espaciadas y no estima robusatamente los parametros. 2. La solucion de las ecuaciones diferenciales no tiene la precision suficiente y hace que la respuesta este mal.
Hernandez,Yvan,30,30,60,"1. Solamente el makefile y graficas funcionan bien (aunque son imposibles de ver con los puntos). MCMC al parecer no da las respuestas correctas, nunca se imprime valor medio e incertidumbre. 2. Tengo sue√±o.pdf! Mismos problemas que en el caso anterior."
Hong,Luis,0,0,0,
Molano,Juan Pablo,45,45,90,"1. Da segmentation fault 2. Solamente el Makefile y las graficas estan bien, pero el MCMC da respuestas incorrectas."
Perez,Juan,30,0,30,"1. Makefile y graficas funcionan bien,pero el MCMC da resultados erroneos 2. Nada"
Vargas,Kevin,30,30,60,Solamente makefile y graficas funcionan bien. MCMC no da las respuestas correctas.